i like itu	positive
inti sukses depan amin	positive
very good	positive
bagus cuman tolong tambah bank bca	neutral
nanovest ya rugi juta rupiah grafik enggak real	negative
alhamdulillah	positive
aplikasi investasi daftar ojk ya ginigak jelasbeli emas turuntapi emas persentase untung merah merugiditanya bagaimana jelas nyasampai enggak kabarngeri ngeri sedap aplikasi investasi giniuntung coba dkit langsung tarok duit jamin rugi langsung nano enggak tau	negative
puas	positive
keren bang	positive
enggak id tag tulis jaring lagi baik tolong kasih terang kalau belum pakai	negative
akun curi orang tolong kembali lagi	negative
ok	positive
lumayan baiknanti problem selesai update bintangnnyatrms	positive
ok pul	positive
aplikasi gjls	negative
gera nano turun	negative
coba	neutral
ok good	positive
transaksi cepat terimakasih	positive
asu	negative
oke bagus proses cepat	positive
aplikasi bagus anugerah erti paket	positive
nice aplikasi	positive
lumayan bagus investasi	positive
the best applications	positive
aplikasi mudah mula	positive
terima kasih sudah hari ribu toppppppppppppppppppp pokok	positive
tolong apps lumayan ngeleg	neutral
verifikasi kyc email pakai banget	negative
saran gua skip bro aplikasi	negative
bagus transaksi lumayan cepat	positive
interface simpel bingung user	positive
suka aplikasi karena mudah paham dan proses cepat	positive
mudah nominal pakai rupiah enggak bingung fee rendah	positive
saya daftar umur enggak	negative
belum paham	neutral
aneh sih jadi takut eh memang tulis free biaya platform harga beda contoh seperti bitcoin market rp juta nano sudah rp juta hrganya bisa beda nila belum lagi kena ppn	neutral
lengkap	positive
mantap	positive
mantaapppp	positive
kyc tolak mulu jelek	negative
berita lengkap mantap mudah ambil putus	positive
tolong bantuin enggak kak kena tipu mohon bantu	neutral
baik tampil ui ux kak biar simple mudah ajar pemulaa	neutral
aplikasi lancar mudah simpleok banget	positive
user friendly aplikasi berat tapi normal keren	positive
mantap staking nanovest bukti bayar	positive
bagus aplikasi lengkap moga fee tarik dana gratis	positive
biaya mahal app asa berat	negative
weh minimal kasih tau bikin masuk bilang nama aplikasi langsung keluar bot aplikasi saja kagak ngebantu payah aplikasi buang cari aplikasi bahaya gue kagak tau	negative
oke	positive
aplikasi admin tipu bangkek	negative
cocok ajar investasi	positive
grup community banget atur aplikasi tulis akun batas hp apa	negative
transaksi moga untung	positive
mantap moga tingkat fiturnya	positive
bagus	positive
mantap aplikasi	positive
moga bantu	positive
aplikasi bagus bantu mula investasi	positive
rifiu jujur aplikasi betul jelek duit tarik rekening bank katnya tunggu kerja tunggu sudah masuk dana rekening aplikasi tahi enggak download aplikasi tipu	negative
real	positive
halo install aplikasi nomor datar daftar muncul hapus akun akunyang hapus daftar nanovest no telp kendala mana	neutral
limit order ok danagopay wd	neutral
banyak update update enggak	negative
langkah kenal investasi mudah lancar	neutral
enggak makek aplikasi email notif nanovest	negative
bagus mula saja ajar investasi top up mudah lancar alhamdulillah ya coba kalo gue coba lu kagak	positive
coba moga bagus	positive
merbot	neutral
mudah	positive
nanovest nanovest	positive
tanam saham aman apps karena sudah dapat izin ojk mantap suka nafizahan tman tman dftar silah isi undagannya auto bnus tanam saham aplikasi cocok tanam saham jangaka aplikasi modal investasi aman ragu	positive
bagus ajar sukses aplikasi	positive
terima kasih nanovast dah bikin cuan dah baik keluh dari	positive
enggak bisa akses kyc salah sistem mulu	negative
maaf wd dana enggak e walet	neutral
kode undang saldo ribu kosong	negative
saran developer update tambah log via emailmedia sosial log nomor hp karena nomor saja matihp hilang jadi mudah log platform akun	neutral
mantap banget nanovest ber infestasi mudah	positive
paham proses	neutral
okinget giftnya	positive
keren banget apknya	positive
kerja nanofest bisa hasil uang cepat	neutral
rekomendasi	negative
cari cuan aman	positive
hxnzy serta level gabung akun aktif bonusbonusnya aplikasi nanovest aplikasi bagus rekomen aplikasi senang lancar aplikasi lancar aplikasi kendala pokok aplikasi bagus	positive
semangat nanovest terus kembang karena proses khianat hasil ig	positive
lumayan bagipemula	positive
opsi tarik uang tambah minke olshop donkbiar biaya adminnya	neutral
enak investasi	positive
gua fitur keren banget gua notabane mahasiswa explore tambah alam finance	positive
tatang	neutral
buruk gua kecewa iklanya saldo tambah hari gua deposit tambah ngurangin anjink gua tipu enggak tarik dana	negative
enggak login suruh masukin tag pas masuk ganggu sistem silah coba sudah coba terus sudah ti hps tetap saja enggak	negative
kendala akun batas saldo dalam	neutral
bagus mantap cepat aman berkat super quantum engine komputer quantum	positive
mudah transaksi saham emasspenarikan cepat	positive
bagus aplikasi	positive
terima kasih sudah terima anggota digrrup	positive
okyy	positive
tolong buat sistem limit crypto ajar kripto fitur full informasi crypto	neutral
kecewa ya akurasi nilai rating saham prediksi harga cenderung akurat rugi invest saham percaya hasil analisa saham lenceng	negative
ck app elit kirim verif sulit	negative
aplikasi saham tebaik	positive
gagal ya bagi selfi enggak cocok sama dukcapil tolong bagaimana sudah enggak uninstall tolong lah	negative
top	positive
mudah ajar mantap	positive
verifikasi email bagaimana gue enggak enggak kirim email gue	negative
bagus	positive
buka pakai wifi enggak pakai paket data langsung buka buka aplikasi aman aman saja jaringanya	negative
verifikasi wajah gagal sudah	negative
lumayan	positive
tolong bebasin pajak pertaransaksi	neutral
alhamdulillah nanovest mantap mudah cepat paham moga depan tari pakai dana lebih is the best	positive
kasih bntang dulu kau bagus tambah entar gi	neutral
love this app	positive
dan proses	neutral
coba bagus enggak	neutral
nanovest nyediain tari dompet digital ya	neutral
keren cocok untukk mula	positive
bantu	positive
investasi mudah	positive
masih ajar	neutral
mudah erti	positive
moga aplikasi baik mudah untung	positive
settingsshortcut on mau be the best for you tapi be the best for you tapi be the	positive
top up biaya gratisluar terima kasih	positive
coba	neutral
moga aplikasi jalan	positive
lumayan	positive
daftanya susah enggak muncul email	negative
assalamualaikum teman mula iyya bagus	neutral
butuh update respon aplikasi lelet banget	negative
moga janji	positive
baguaa	positive
bagus banget nanobyte	positive
wd cepat deposit cepat good jobs	positive
aplikasi bagus instruem inbestasi saham emas kripto sayang aplikasi ngeleg baaaanget	negative
coba coba	neutral
proses cepat	positive
susah masuk email dll lengkap tapi masih susah top upnyaa alas lengkap data sudah kirim capeeeek deewk ngabiskan saja didownload saran	negative
mantap moga cuan	positive
suka bagus banget	positive
shiba goto the moon	positive
payah admin enggak bantu akun gua kena hack orang nomor hp langsung ganti retas gua bantu admin sudah surat nyata sudah poto ktp selfiktp ribet ajg bilang miror balik potonya padahal poto sudah benar dasar enggak bantu benar ajg enggak tindak nysel benar gua deposit dsini bngsddddd	negative
nice nanovest	positive
aplikasi bagus banget mula kayak ajar investasi fiturnya enggak pakai ribet aman jugaaa	positive
ok simpe tampil ok mudah mula	positive
moga nanoves bantu investasi	positive
install gara wkwkprojectcukup puas simpel mudah tinggal coinnya dibanyakin bintang auto order	positive
coba ajar investasi aplikasi lumayan mula	positive
mantap sudah	positive
mohon kak tolong tipu suruh ini nomor pin orang langsung blok tolong kak	neutral
bantu finansial	positive
mantap sih	positive
kendala verifikasi email	negative
tipu kedok investasi sih enak banget hapus aset orang beli aset bayang saja beli jta eh turun itu aset anggka kena delesting kembali pas turun saja sisa kmna rugi banget anjir	negative
gazz	positive
mudah erti	positive
sayang enggak tarik tunai ewallet	negative
enggak jelas banget sudah dijelasin rinci enggak dapat solusi akun sudah hapus karena nomor daftar enggak aktif hilang serta hpnya daftar pakai nomor ktp eh enggak akun sudah hapus kalo kayak begini diamdiam nyimpan data user database ya parah banget	negative
bagus pakai refferal vianly	neutral
suka aplikasi	positive
tolong nanovest fitur withdrawnya fitur e walletnya pindah jual aset kripto saham e wallet rekening bank bank portofolio income kena habis pajak aset saham	neutral
mantap investasi	positive
buruk operasi lelet serba lelet masukin otp salah tros	negative
bagus aplikasi bantu uang	positive
crypto nilai buy nilai sell rendah posisi sell check details inti harga crypto real time	neutral
tolong baik aplikasi ambil foto gagal sudah ikut arah aplikasi baik aplikasi	neutral
bintang sudah limit order tambah	positive
ira bohong susah foto kyc ngalamin kyc aplikasi belah lancar saja skip	negative
verifikasi kyc lalau gagal	negative
jalaluddin	neutral
bun nemu kurang	positive
rocknroll gasss	neutral
baik	positive
aplikasi simpel gampang	positive
enggak loginpadahal aset	negative
kok enggak bisa verifikasi email ya	neutral
daftar susah enggak verifikasi email aplikasi kaya berat banget	negative
nice aplikasi	positive
mnatal	positive
aplikasi rekomendasi mula mudah paham	positive
aplikasi proper	negative
mantaapppppo	positive
perfect	positive
kenapa tarik dana rekening bri enggak	neutral
nano speed apss suka banget pakenya anti ribet tapi ndk fitur tari dana ya percaya penuh trede ya sukses nano	neutral
mantap	positive
tuju bahagia	positive
mudah mudah amanah tahan	positive
bagus pandu milyarder muda	positive
pilih invest dana aman bank nama daftar cari ref salin hari	positive
inti orang investor	positive
aplikasi bagus banget sumpah kode	positive
belum fitur earn staking	neutral
aplikasi mudah moga profit	positive
jual kena nilai koin beli kena makan t app koin tambah enggak bappepti data enggak realtime mode pro enggak rugi guna	negative
okkwkw	positive
parah kalo ngadain event biar user salah paham lucu lu ngadain event ribet	negative
layan customer servise ramah	positive
tarik	positive
hyungnim reffer maret download kesini	neutral
ok	positive
profesional nanovest	positive
belum coba jadi bintang masuk kabarin wkkwkwkw	positive
aplikasi suka lag	negative
mudah cepat kialt	positive
senang kaum	neutral
the best	positive
mantap investasi	positive
bagus investasi aset digital	positive
regris ypc kok kirim email enggak masuk masuk ya	neutral
cashoutnya tolong baik systemnya lelet	negative
nonovest top mantap is the best	positive
akun akses ya akun batas tolong baik ya	neutral
aplikasi bagus mula mudah guna aplikasi	positive
masih mula ajar trading moga aplikasi baik mula	neutral
mudah lancar	positive
aplikasi tari gagal nama rekening nama daftar aplikasi beda bagaimana nama rekening daftar aplikasi bisa aplikasi bilang beda dasar aplikasi enggak tipu	negative
exchange murah mantap	positive
tampil ui oke biaya tarik uang admin standar biaya withdraw kripto minimal gasfee tawar kalah platform seperti indodax pluang pintu rang minimal withdraw gasfee attention konsumen	neutral
selesai kyc email masuk belum beli sahamsaya kasih b nanyi kalau email masuk kasih b	negative
burn	positive
aplikasi mudah paham	positive
good jobs	positive
moga cuan	neutral
bagus bos	positive
the best tolong grafik ubah candlestick lebih ok	positive
goodjob	positive
bagus mudah cepat	positive
aplikasi telat udet harga sell harga sambung	negative
very nice	positive
keren transaksi enggak sampay menit selesai respon admin via email cepat ramah terimakasih nano vest maju sukses	positive
salam sukses	positive
top	positive
good aplikasi	positive
tolong ubah bijak akun hapus dapat pulih	negative
invest mudah	positive
coba	neutral
masukin verifikasi email sulit banget sudah coba email tetap enggak bisa	negative
kode referal	neutral
hati hati inpestasi akun kunci alas hp rawan sadap uang sisa ribu akun dantida masuk suruh unistal install saja tida masuk inpestasi unga bayak	negative
aplikasi nanovest sederhana mudah paham mula profesional bidang saham trading i hope tapi get something worth itu	positive
moga mju trimakasih mula doa semu	positive
bagus	positive
coba ya moga sukses	neutral
temu akun kembalikini sudah logintinggal mnunggu panentrimakasih nanovest	positive
ok	positive
sumpah sesal taruh dana aplikasi ribet tari tunai nama norek sesuai muncul notif nama rekening sesuai hhhadddeeeehhhhh	negative
mantap	positive
mula	positive
mudah paham profit mantap aplikasi	positive
keluar biaya beli kena pajak jual kena withdraw potong ribu mending platform indodax gratis	negative
akun kunci masuk pin aplikasi alami ganggu proses ticketing email responya bicara robot manusia live chat menu bantu isi gform isi ribet upload foto tulis tangan buka akun tipu aplikasi update baru aplikasi hapus fitur bantu login nomor handphone itumempersulit	negative
aplikasi nge bug verifikasi biar kyc sudah isi email enggak pesan sampai berapa ngulang gjls	negative
lelet pas kyc but overall good and update coin mantap moga saja coin micin buah berkah	positive
mantapaplikasinya bagus recommended investasi sebelumny kendala good job masalah	positive
ok aplikasi cocok mula	positive
mantul aplikasi nanovest	positive
good	positive
aplikasi gampang erti	positive
puas investasi nanovest mudah paham aplikasi	positive
oke siiip	positive
pas mau masukin pin transaksi aplikasi ngelag lambat masukkeluar market	neutral
mohon kasih ewalet dana	neutral
nanovest percaya	positive
bintang fitur tarik uang ewallet	positive
mudah fiturnya bagus simple	positive
saran harap tarik tunai via ewallet top up ewallet	neutral
rugi tari	negative
good jobs	positive
jeu	neutral
mudah paham good	positive
enggak bisa narik saldo aneh sudah baca succes gbisa	negative
akun enggak buka karnakan nomor daftar hilang bantu buka	neutral
biar bintang	positive
saham bursa amazon buka sell pending mulu	negative
aplikasi bagus mudah paham kontrol main saham bagus	positive
mudah erti moga percaya terima kasih	positive
nanovest cair uang ewalet	neutral
sampah	negative
moga bisnis danhalal	neutral
kendala saya enggak wd dana	negative
terimakasih peluang ajar investasi modal	positive
top up apa ya	neutral
rekomen nanovest pasar saham ayo gabung nanovest	positive
kelaz	positive
bagus	positive
lumayan mula	positive
baik pokok	positive
such a good aplication	positive
aplikasi jelek	negative
bagus rekomend	neutral
bagus	positive
lumayan bagus aplikasi enggak ribet	positive
ya update progres	positive
pengin cari ilmu hasil	neutral
aplikasi bagus tawar instrumen saham us etfs pilih tolong biaya transaksi pangkas fitur buy limit sell limit mudah eksekusi terima kasih	neutral
bagus	positive
agk lama nunggu profitnyatingkatkan lagi ya	neutral
aplikasi nakseleng	negative
moga buat semangat	positive
aplikasi tipu ini pakai kode relay ribu bohong aplikasi an ini	negative
jual beli kripto mudah dapl	positive
mantap ok	positive
aplikasi enggak niat sudah orang kyc akun kendala verifikasi akun email enggak aplikasi	negative
update proses deposit tari pakai ewallet	neutral
invest untung no tipu tipu	positive
bantu investasi modal	positive
mantap aplikasi bagus simpel tahan	positive
banget lola alias loading kaya bikin berat hp saran saya cuman aplikasi pering ukuranya biar enggak lola berat	negative
oke mantap	positive
lambalat	negative
daftar jangan sulit	negative
mudah erti	positive
somoga nanovest aman amanah nasabahinvestornya	positive
ref gilsya	neutral
bagus cepat	positive
iklan enggak hapus sungguh jengkel	negative
sudah pakai memang bagus app ui simple saham as crypto lengkap cuman fitur depan ditambahin kategori jenis saham contoh usaha automotive kaya ferrari gm toyota dll enggak cape search lihat saham kategori	neutral
nanovets aplikasi mantap bagus inventasi bagus jujur trimakasih aplikasi nanovetsnya bantu masyarat apknya sudah bagus gangu gugat yhhh devoloper trimakais	positive
baik alhamdulilah	positive
tingkat diagram tanggal	positive
lancar jaya	positive
thank you	positive
moga percaya	positive
sukses selalu	positive
bagustapi tolong tambah fitur tari via danadong	neutral
bagus investasi	positive
masuk email bilang sudah daftar untung belum masang dp masang hilang uang pas dp apa bintang turunin	negative
force close terusssss	negative
so simple	positive
ajar	neutral
proses transaksi cepat	positive
tau aplikasi nanovest ya mantab nano	positive
senang aplikasih	positive
mudah sukses	positive
simplegood job nano	positive
bagus moga ubah	positive
jujur kecewa banget admin bantu verifikasi wajah ribet enggak tau ikut arah ai depan mohon baik ya development kyc bikin ribet	negative
bagus banget	positive
mintolong gue sudah call cs perkara nomer hp gue hilang gara gara hp ilangterus saldo dilam akun gue enggak ada solusitolong ganteng	neutral
gampang tapi khusus negeri	neutral
aplikasi mudah	positive
fitur top up dari wallet shopee pay hilang kbnykn app jadi berat hp cara sudah saya pakai shope tolong lagi fiturnya	neutral
oke coba	neutral
gila	positive
kalo app investasi cerdas dikit logout transaksi hambat tolong baik	negative
saja karena sempurna	neutral
sukses	neutral
enggak erti bahasa inggris	negative
oke bantu investasi	positive
lumayan nabung hehe	positive
mudah orang awan	neutral
bismillah mudah alhamdulillah terimakasih	positive
amanah	positive
moga berkah investasi amin	positive
mhn prosentase pl coinsaham ditampilin luar langsung enggak buka klik lihat lihat kak tq	neutral
transaksi lancar	positive
tolong kembali shopeepay alat transaksi tambah saham kryto lokal	neutral
tampil registrasi mudah simple sayang investasi saham indonesia	negative
yuk tumbuh	positive
sekarang pelit misi undang teman	negative
aplikasi bagus mudah	positive
kembang	neutral
kalo pindah menu ngelag baik	neutral
nanovest batas akun why perangkat rentan ganggu aplikasi bahaya mata cuk gue hapus guna nanovest kecewa layan hp gue samsung kenal security	negative
lumayan cocok mula	positive
tambah tari uang via e wallet update baru biar mudah guna pakai wd virtual dana cepat	neutral
apliaksiih mudah praktis	positive
okehh	positive
kasih ngertiuda erti ubah	neutral
pakai aplikasi bagus banget invest	positive
tolong verifikasi email baik enggak dapat notif email pagi	negative
nanovest retas orang bagaimana	negative
aplikasi bagus ringandan lupa reward refferaljoelphoky terimakasih	positive
mantap	positive
aplikasi bagus mudah jual beli	positive
akun batas saja daftar	negative
sesal invest cobacoba eh untung buntung topup kena ppn buy kena ppn sell kena ppn transfer wallet nanovest rekening bank kena ppn coba saja sudah potong pajak	negative
update lengkap tema beta	neutral
aplikasi ngadain event ajak teman buka bikin untung bikin rugi juta ngumpulin referral blokir akun terus ambil lagi saldo kata karena curang parah banget kalau ambil ambi orang pakai kode curang jangan semua hadiah tarik semua memang lo ngajk orang enggak buang	negative
bintang gabung bagus kendala bintang	neutral
muncul notifikasi akun batas	negative
bagus banget apknya pajak pas invest pas tarik nak pajak bagus pas investasi saja pajak	positive
sendat tombol android kadang enggak	negative
ngeleg banyak loading susah respon bagaimana topup m verifikasi email takbisa	negative
tahap terima kasih	positive
bagus transaksi cepat	positive
aplikasi bug mending pilih peluang saja	negative
nanovest tolong token bitgetbgb ondo terimakasih	neutral
terima kasih nanovest kenal kembang investasi ajar kembang maju orang minat partisipasi investasi maju	positive
tarik uang rekening salah	negative
mantap jamin investasi	positive
mntapcepat respon msalha login	positive
moga saing toko cripto	neutral
biaya admin tarik crypto biaya admin transfer bank dasar aplikasi scam	negative
download kasih bintang	positive
moga hasil	positive
verifikasi kycnya email enggak kirim	negative
app simpel	positive
investasi gampang	positive
kecewa aplikasi hapus data pribadi akun email identitas pasti investasi ribu enggak ratus crypto saham tari uang masuk akun nomer hp dana shopee pay ovo ujungujungnya pakai rekening bank enggak pakai no hp cair saldo pakai rekening bank enggak pakai nomer hp enggak login nano vest	negative
ribet daftar bbrpa gagal verifikasi wajah padahal ulang sampai kali ikut tapi tetap gagal terus sampai bosan mohon maaf fakta alami	negative
keren banget cuy	positive
nanovest cepat dalam transaksi	positive
potong jual crypto lumayan prajurit cacing goyang atur potong tanam modal tarik sesuai untung solusi baik	neutral
bantu butuh ekonomi	positive
install setting bagus beli saham luar promo uinya mudah erti tapi kadang suka berat ya sisa okey coba investasi	neutral
tarik e walet top up fasilitas	neutral
invest saja pas kyc doang susah cahaya sudah bagus otw uninstal lagi buang	negative
manfaat	positive
muanteeeep banget deh nanovest jamin cuan pokok ayoooooo investasi sini pakai ragu	positive
widraw pakai e wallet minharga nbt turun bagaimana janji naikk	neutral
edijalali	neutral
ok banget	positive
tarik tambah duit jajan	positive
install nanno vest pakai referel tambah saldo gratis gaess lumayan ibnumalik	neutral
good platform	positive
download mending download indodax saja aman percaya gua invest hilang gra ganti hp account gua hapus curiga enggak usah download aplikasi enggak aman	negative
keren	positive
masuk bug halang	negative
i like	positive
akun saya kuci bagaimana solusi	negative
proses kyc susah kirim pesan	negative
aplikasi bagus	positive
mudahaman mantap	positive
mantab	positive
bang akun sayah ambil orang aman enggak	negative
kecewa witdraw crypto enggak masuk	negative
bagus gampang banget aplikasi	positive
kak daftar kycnya verifikasi email ya email	neutral
biasableh coba	positive
tari mahall	negative
kak tolong hapus akun nama putri aulia alamat bandung bojong sari camat bojong soang akun nyuri mohon kerjasama takut salah	neutral
aplikasi bagus cocok mula guysss ya	positive
ragu	positive
mantap informasi lengkap mudah beli	positive
mudah erti	positive
coba oke	positive
rekomendasi	positive
aman login login aman pin biar orang enggak lihat saldo	negative
aplikasi bantu	positive
mudah jangkau	positive
xx nn noo ptnhtq	neutral
nanovest bagus investasi mula	positive
aplikasi aneh kadang akun batas pas restart hp akun aman malam akun batas hp aman virus aktivitas curiga tolong nanovest baik aplikasi bug bagaimana	negative
coba mudah mudah dapat hasil	neutral
keren aplikasi	positive
tau salah youtuber so simple enggak ribet kudu pindahpindah aplikasi mudah topup pakai wallet virtual account ajar simple thanks ya	positive
bagis puas	positive
like itu	positive
okkk	positive
grafik chart harga banding broker kadang selisihapa bandar main spread harga ya	neutral
ui mudah paham	positive
gua takut bintang iklan aplikasi lakilaki pakai topi ngondek asli tolong tampil muak banget gua	negative
keren	positive
temu aplikasi trafing lengkap saham crypto user interface sederhana dapat saldo rp refferal acesatria	positive
verifikasi kyc banget	neutral
good job	positive
aplikasi nanovest sedia transaksi kripto lengkap kripto	positive
gera grafik saham enggak gerak enggak lihat cari pasar saham ribet banget harus klik tolong simple saja apknya kaya aplikasi jual beli barang shoopee bukalapak dll	negative
bagus	positive
tlong bos baik kenapa lah gue kasih bintang	positive
coba tau tambah	neutral
aplikasi bantu moga anggota sehat	positive
nanovest baik daftar rumit mudah paham i	positive
langsung bintang nanovest harap updatediupdate munculah akun batas kesal pis sudah koin harga tambah turuntambah acar batas akun komunitas nanovest bubar jalan	negative
aplikasi bagus mula tolong tambah chart chart lilin batang biar	positive
join deposit muda	positive
proses kyc ribet eror laman verifikasi email kolom angka verifikasi pesan verifikaski muncul email muncul bagaimana verifikasi kolom verifikasi enggak muncul aplikasi scam cari download refereal	negative
baik thx	positive
mohon bagus aplikasi	neutral
mantap guna	positive
woi	neutral
cobasemoga bagussaya bintang	positive
terimakasih nanovest pakai aplikasi beli	positive
jajajia	neutral
sudah bagus kendala tari ewalet dana	neutral
nyaman saja	negative
bantu	positive
coba bos	neutral
bagus mula coba investasi	positive
bugnya gue depo kagak	negative
enggak jales banget aplikasi	negative
mantap fitur tampil	positive
enak pakai aplikasi mudah	positive
revisi bagus update	neutral
aplikasi saham bagus invest	positive
moga sukses	positive
oke	positive
nice aplikasi for crypto	positive
the best of the best aplikasi for invest	positive
nyala	positive
kalau mantap nnt bintang	positive
pakai	neutral
desain aplikasi bagus verifikasi foto dukatakan alami blur lihat kamera tolong kembang jelas solusi	neutral
kyc susah banget	negative
bagus	positive
mudah paham	positive
nanovest kok enggak bisa masuk saja sudah pakai fingerprint	neutral
susah ribet kalih daftar kycnya coba daftar kalih verifikasi enggak masuk	negative
bagus banget investasi	positive
halo guna aplikasi	neutral
pakai aplikasi memang enggak enak banget hp tersendatfreeze alam cripto nanovest pindah btc platform	negative
tolong blokir akun nama agusrrh akun retas orang tolong terimakasih	neutral
masuk terang sistem ganggu	negative
good moga harga toke semangat	positive
oke saja	positive
good enggak sulit	positive
kasik bintang penuhtolong wd acc	positive
very good	positive
suda rekam kepalaq	positive
investasi token negeri	positive
ok gass	positive
coba	neutral
mudah banget beli saham saja gampang	positive
bagus simple	positive
daftar ribet bantu	positive
lag buka menganggu depan perhati sistem stabil lancar buka fitur menu cepat kerja performa sukses coba aplikasi invest bukti bayar aman modal rendah coba mantap platform	neutral
aplikasi recommended banget mula treading investasi gua saran developer tambah ewallet tari mudah akun bank	positive
terimakasih nanovest sumpah invest kriptop gampang cocok ajar mahasiswa tabung aman the bast pokok sukses	positive
mudah erti jual beli aset kripto saham negeri mudah nyaman nanovest is the best maju terussssss	positive
capek update	negative
bagus tari enggak pakai ewalet dana ovo gofay	negative
bagus mula	positive
bantu saham mula	positive
top up bagus sukses beli saham google pending ya	neutral
lumayan bagus ajar forex trading	positive
harap tau harga cripto sesuai harga	neutral
nanovest mudah investasi mula	positive
aplikasi bagus	positive
kalo paket kritis suka enggak lihat	neutral
ampun kyc sulit mati gagal mulu coba ruwet auto unistal	negative
awesome	positive
bagus tolong moga bekerjasama e wallet tari	positive
mohon serta info biaya fee jual beli biaya switching rupiah dollar biaya tambah tari rekening nasabah jadi bahan timbang depan review kasih bintang sisa jawab terimakasih	positive
aplikasi bagus aman bagus aplikasi sudah daftar ojk investasi miripmirip gambling ya depan bulan tahun harga harga turun faktor nentuin harga turun prediksi rajin baca berita terjun investasi baik pantau berita global seminar online gratis	positive
serta dengan hati bersih ikhlas doa ikhtiar koinamulet masalah pasti solusi manusia seharusny	neutral
gugle autikator tidak msukn kode selalu salahpdhal suda kode slinmaap saya kurngi bintngnyabhaya aplikasiakun tidak buka	negative
bagi indah nanodenny	neutral
mudah paham erti	positive
rekomend mudah paham mantap banget	positive
nanotag susah	negative
spread harga jual beli gede banget parah rekomendasi aplikasi	negative
bahagiaini cari	positive
memberitahu email kyc kode kirim kirim	negative
selamat	positive
aplikasi gjls akun hapus portofolio aneh	negative
mantap	positive
sah real harga mahal papan gera	negative
kena tipu aplikasi	negative
bagus aman	positive
tolong buka tari via e wallet repot bagu via bank	neutral
aplikasi nanovest mudah paham fitur dalam lengkap koin invetasi saham nanovest jual beli saham mudah pakai sistem jual beli instan pakai sistem limit order sistem deposit tari metode bank ewallet feenya rendah promo promo tarik gratis saham even even	positive
aplikasi trading erti enggak ribet	positive
aman cocok banget pokok	positive
enggak bisa verifikasi email enggak ada salah	negative
penasaran hasil stake nbt kalau bagus bintang	neutral
kak whidraw crypto network gamasuk masuk ya sudah benar memang proses pliss moga direspon	neutral
mantp	positive
tambah semangat nabung	positive
coba moga kecewa	neutral
aplikasi bagus mudah erti	positive
update buka bagus bug hasil untung enggak jelas akumulasi	negative
umasolihi gaess	neutral
mahrusoke	positive
sso	neutral
simpel praktis investasi nanovest bantu daftar menggunakaj gbnano beli jual saham langsung real time bebas biaya admin tari saldo investasi cepat saran tolong tambah fitur kirim wallet crypto	positive
luv	positive
lambat aplikasi	negative
good jobs wd cepat	positive
friendly user very good	positive
mudah mula	positive
benar investasi dsri nanovest mudah paham simpel cuman minus iya biaya transfer bank orang investasi kesini pikir aplikasi biaya sebut mahal enggak kaya aplikasi rendah enggak ada smaa tolong ya admin kalo bisa kasih biaya kasihan mula ajar invest	neutral
app lambat bikin sagne	negative
okeee keren	positive
kecewa bijak nanovest akses akun akun ktp kalo sudah daftar sudah enggak kyc sudah hapus akun	negative
coba	neutral
makan	neutral
aplikasi sudah bagus handphone tolong adakan pclaptop tampil luas	positive
aplikasi delay moga tingkat lancar	negative
aplikasiny bantu karena pas memasukkn akun masuk kodeny pakai akun satu lagi sama enggak masuk kodeny	negative
mudah mantap	positive
aplikasi pas top up gampang banget saja jalur e wallet lengkap crypto wallet indomaret alfamaret gilir pas narik susah banget ingat pakai aplikasi	neutral
apliaksi bagus cashback beli kripto begitu event cashback beli kripto	positive
anjg enggak verifikasi ktp foto ktp saja susah fokus kamera cahaya sudah pas	negative
turut masih transfer dana	neutral
transfer jadi mudah	positive
minimum deposit	neutral
mula ok enggak ribet	positive
ganggu sistem	neutral
apliksai investasi lengkap saran metode tari dompet digital gopay dana terima kasih saran moga terima	positive
ajar	neutral
bngst sudah ngemis rateing harus kasih bintang eh kartu hadiah gosok enggak jadi enggak dptbngst bngst	negative
coba	neutral
aplikasi tolol	negative
susah verifikasi ktp	negative
aplikasi bagus aduh nano moga baru lag enggak enak pakai mah oke mantap lag saja terimakasih moga baru	neutral
mudah invest rendah moga lancar	positive
senang	positive
perdana moga kecewa	neutral
mantapppp	positive
moga ajar inves	positive
akun batas perangkat rentan ganggu aman	neutral
fitur limit crypto	negative
bagus loh suka nanovest muachh	positive
optimal kyc saja banget	neutral
ok	positive
mantap klaim	positive
pas verifikasi kyc kenapa enggak masuk gmail sudah banget tetap saja enggak masuk	negative
lumayan bagus aplikasi wallet	positive
mula moga berkah bismillah	neutral
coba kalo sukses alhamdulillah	neutral
bagus banget mudah erti wd bagaimanaisi alamat dompet	positive
tolong admin hapus data nama reina pipit wulandari takut salah orang	neutral
mantap	positive
bagus ui ux	positive
nanovests aplikasi gua rekomendasi aplikasi resmi ya gaes aman murah admind mantul	positive
tolong nanovest kirim alamat email banget kaya anjg	negative
bagus lanjut	positive
beli jual beli terus jual tinggal zaman enggak bangga	negative
siiip mantap mohon tambah agr bayar listrik pulsa dll	positive
aplikasi mudah erti paham	positive
no comment	neutral
enggak narik crypto jaring	negative
coba hasil nano vest ayo buru investasi nano vest aman percaya	positive
oke banget dah pokonyamahh	positive
kesini aneh kagak buka aplikasi gue lihat kembang profotolio aset saham gue sudah beli	negative
maaf bintang kurang	negative
tari pakai bank daerah enggak	neutral
coba beli shiba	neutral
mudah untung	positive
keren banget sumpah	positive
bismillah moga cuan jumat mei	positive
maju krypo indonesia	positive
aplikasi friendly mudah paham mula harga jangkau	positive
untung jangka pendek nanovest potensi	positive
mantap gampang erti	positive
coba	neutral
ok sip bantu	positive
ing main	neutral
wow mantap	positive
saham as percaya indonesia denga maju jaman orang sukses	positive
coba	neutral
yiocoucuc	positive
mudah simpel	negative
senang	positive
transaksi lumayan cepat topup mudah banding kompetitor	positive
mudah paham tari cepat	positive
sat set cepat mudah erti	positive
coba	neutral
suka kali	positive
inmpertasi cepat	positive
bagus recommended	positive
senang aplikasi mudah paham	positive
lambat	negative
sumpah aplikasi crypto enggak crypto segitu saja potong beli cripto aneh aplikasi	negative
ya coba	neutral
bagus recommended	positive
aplikasi jalan bagus cuman beberapa hp proses kyc alami kode google kirim mohon tangan ya terimakasih	neutral
bagus enggak rugi ikut minat pasar aman aplikasi fungsi dgan lumayan tabung untung dana invest	positive
baik	positive
moga	positive
didiemin saja moga invest janji	positive
simple mudah cepat	positive
moga profit	neutral
keren	positive
akun tibatiba lupa pin	negative
ok	positive
bagus aplikasi mudah paham orang awam enggak ribet wd gampang cocok mula orang enggak enggak ribet	positive
mantu ontull gacorrr jackpot	positive
segi tampil tarik tapi proses verifikasi kyc kendala email terima pesan verifikasi apa jadi coba transaksi	neutral
moga mula investasi	positive
no komen bagus banget	positive
opsi wd ewalletmohon tambah opsi tari ewallet	neutral
iklan	negative
mudah investasi crypto nanasemoga harga roket	positive
terimakasih nanovest saham diri terimakasih bantu referensi gbnano alam portofolio tingkat ajar ajar ajar kalah bandar alam tahu sinyal sinyal pandu saran saja	positive
produk bagus	positive
aplikasi amjinkkkk data saya babi akun gue kunci enggak buka hungin cs tetap enggak buka amjinjj banget aplikasi mana no hp pkw daftar enggak aktif beybeyku	negative
bagus sihtapi nilai selesai tugas ulas nilai aplikasi bagus bantu anggur hadir aplikasi manfaat kerja hasil uang nol operasi mudah kagum modal good job nanovest	positive
gogogo	positive
hllo nyimpan no rekening enggak persis ktp aplikasi nanovent mohon bantu	neutral
siiip	positive
pas bikin nanotag salah jaring bagaimana aplikasi buruk mohon baik	negative
coba saja biar enggak penasaranklw enggak bagus cari	neutral
i love nanoves	positive
bagus mula	positive
oke satusatunya investasi etf us market aplikasi investasi indonesia sayang forex usd spread susah kalo rekomendasi teman enggak coba investasi garagara spread ini	neutral
keren nyaman moga raih untung	positive
proses kyc kirim verifikasi gmail masuk	negative
lumayan bagus inves coba transfer cepat hitung menit tks	positive
lumayan tambah cuan	positive
nabung receh	positive
aplikasi bagus sayang hp ram bagus bugs aplikasi khusus hp bagus	neutral
real akurat	positive
puas	positive
kok enggak bisa masuk	neutral
proses deposit cepat	positive
aplikasi lambat terima transfer bitcoin hilang bitcoinnya	negative
fitur aplikasi mudah erti mula ragamnyacukup ber invest	positive
senang investasi nano mudah	positive
aplikasi mudah aplikasi bykpromosinyapromosi suka tempat reksadana dapat bonus cashback asa dapat arisan beli bonus enggak besartp senang tunggu promo ya terima kasih nanovest	positive
isi kyc pasu email email terferifikasi	negative
ajar moga milik untung	neutral
gue download inu promosiin rigen sih brewok amazon target operasi	neutral
mantul	positive
coba	neutral
lag ampun jaring memori	negative
aplikasi sangat guna mantap	positive
jelek enggak masuk gagal	negative
oklah	positive
aplikasi invest mula	positive
thanksyou nanovest	positive
lumayan erti mudah cepat refealkasepiya	neutral
the best mula semiga nelajar karya anak bangsa	positive
aplikasi enggak anjir saldo juta kunci untung buntung	negative
fiturnya mudah erti	positive
tolong ya updatenya hp kentang memori cepat habis	neutral
coba kalau mantap kasih pool	neutral
apknya amanah	positive
ribet	negative
aplikasi bagus mantap	positive
nyantai pakenya	positive
moga aman kedepannyaaplikasinya sudah bagis harga rinci banding saran kalo grafik kasih tanda hijau kalo turun kasih tanda merah depan kalo	neutral
nano keren hiden gem maju nanovest	positive
photo ktp	negative
amsyong invest	negative
aplikasi bagus trading gampang paham untuk mula top up tarik saldo gampang cepat nanovest regulasi indonesia so tolong depan info aset baru untuk nasabah nanovest terimakasih	positive
uye	positive
day use this apps	negative
dowload masuk ganggu maaf bintang	negative
ui mudah unyuuu	positive
tolong nama aldiputra mati aku akun ambil orang tanggung aldiputra tolong mati saja hack orang	neutral
ajar saham seru	positive
reflay dana janji enggak masuk terang dana reflay nyata kok enggak masuk bikin aplikasi janji	negative
invest dipikirakan bintang orang cari reff pengalama ya akun dibatasigak saldo sudah komplain email aplikasi atas nanovestnya enggak suruh ganti bintang hubung email ya jalan sesuai alur enggak aneh begini	negative
wenak	positive
tolong tari tambah ewallet top up pakai ewallet narik	neutral
home saham uang kugame	neutral
b saja	neutral
saldo top up akun masuk duit jadi tahan	negative
investasi ya	positive
kadang kadang benar kak masuk apknya pening kepala	negative
aplikasi tolollll foto susah bilang salah teknis mulu tololll	negative
keren nanovest	positive
kenapa daftar kyc sistem eror mulu	negative
aplikasi bagus invest mula	positive
mantap	positive
coba mula	neutral
bagus aplikasi investasi crypto bagus	positive
aman	positive
ok kak	positive
market aplikasi bagus kurang baik benah sepert interface tambah koleksi jaring blockchain kirim terima walet luas kolwksi dagang moga depan aplikasi tumbuh maju kembang kalah saing lainnga bukti	positive
bingung masukin referensi pakai daryfajar	neutral
set rurut harga besarsebaliknya acak	neutral
kasih bintang verifikasi email sulit banget tolong benah bug verifikasi belum email masuk	negative
terukti okey	positive
aplikasi bagus banget cocok anakanak muda coba beli saham amerika kripto emas modal minim bagus ajar masa pasti modal developer tolong tambah fitur stoploss mudah trader kurang rugi mantengin market amerika ngantuk terimakasih	positive
terimakasih aplikasi bagus	positive
yanju pakai lumayan cuy ribu	neutral
i hope	positive
mudahmudahan investasi etherum buah hasil	neutral
bismillah moga berkah moga depan sejahteraaamiin robbal alamiin	positive
nanoteg nya enggak sudah nama asli tetap enggak kecewa download enggak masuk	negative
suka	positive
proses verifikasi ktp gagal mulu sudah bolak ngubungin cs dibilangin kalo foto ktpnya hasil scan parah	negative
daftar kyc notifikasi masuk gmail ulang kali baca gmail kali salah	negative
suka keren banget sih apklikasi nya update bagus kalau invest crypto jadi gampang moga apklikasi terus josss kagak ada kendala	positive
tolong baik fitur social bug terimakasih	neutral
masih coba coba	neutral
tibatiba akun	negative
ajaj	neutral
aplikasi gbllllok gue sertifikasi sudah nunggu banget suruh ulang ulang bngsat gue saran aplikasi recomended ribet ulang ulang foto ktp scan nunggu gagal jelek	negative
ajar saham	neutral
tolong kecil data lemotttt	neutral
moga sukses hasil hasil saham nanovest	neutral
top up langsung masuk joss	positive
candlestik susah menganalisa	negative
ok aplikasi bantu tolong tingkat lagi	positive
ok mantap banget nanovest investasi aman	positive
enggak enggak tau bikin akun akun batas perangkat bahaya nyuruh hapus aplikasi bahaya kasih pilih logout enggak paham enggak guna so uninstall	negative
ajar investasi	neutral
erti masih coba	neutral
transaksi super cepat moga cepat tumbuh	positive
pasar buka jam wib	neutral
bagus aman lupa masukin ya amin	positive
tari dana ribet	negative
coba mudah mudah untung	neutral
aplikasi rekomen banget yuk gabung	positive
akun batas	negative
deposit cepat kilat	positive
transaksi cepat transparan sesuuai nominal moga	positive
aneh ya dapat eh an enggak sesuai	negative
harap nanovest jual otomatis setting nilai guna nanovest depan	neutral
puasa	neutral
bagus	positive
aset turun	neutral
terus kembang baik	positive
investasi mudah biaya goceng doang	positive
bagus proses instan cepat	positive
trimakasih	positive
sulit masuk alamat email enggak masuk	negative
aplikasi pmbohong masaakun hilang unistall bikin rugi	negative
aplikasi baik jujur sukses bangun indonesia	positive
nano play mulu	negative
gandosss mula	positive
proses top uppenarikan cepat mudah paham	positive
coba coba gara tonton bbk tarik	positive
good apps for investing crypto currency	positive
tolong tambah ewallet tarik tunai deposit via dana tarik saldo enggak dana	neutral
maaf turunin bintang alas karena enggak sesuai harapanmerasa kecewa cuman awal saja enaktolong baik	negative
verif email enggak kirim email sayacape nunggu	negative
moga sukses amin terimakasih nanovest	positive
test drive	neutral
mantap gampang metode bayar all varian mantap mudah paham	positive
akun kunci respon buka	negative
mantap investasi mudah harga bulat	positive
ok	positive
bagus aplikasi	positive
senang	positive
tarik uang wallet tarik uang bank rekening permata bank no rek klik tombol tambah rekening bank mu success nothing happen klik tombol success enggak tarik aplikasi hoax btw harga nbt turun bulan enggak worth invest nbt	negative
slow respon verifikasi gmail	negative
mantaaaab	positive
easy tapi use	positive
puas	positive
nyaman	positive
mantap	positive
moga depan amin	positive
cuannnn	positive
fitur mengirimtransfer token crypto alamat kirim via saldo e walet hal peluang	neutral
keren cadazz	positive
sudah jam koin gua proses masuk tolong bantu bang	negative
bintang kalo bagus naikin bintang	positive
bagus kyc nanovest kyc bbrapa kyc	positive
mantap bilang aplikasi hebat ayo kaya nanovest	positive
aplikasi bagussmoga apknya kembang dan makin bagus kalau pas penarika saldo dana ovo bisaitu mantap	positive
download registrasi karena tonton favorit wkwk project	neutral
main anak tak crypto enggak stop limit	negative
moga jp	positive
up	positive
mantap cocok ajar ajar trading	positive
tolong coins kalo coins mohon cepat update saja lebih enggak bagus banget aplikasi	neutral
biaya dagang gotrade indonesia jarak harga bid ask spreadnya lipat coba beli saham lly sama menit gotrde indonesia untung nanovest rugi coba beli saham mck sama pasar buka hasil maaf bintang kurang utama untung	negative
kasih bintang mula	positive
wd nama rek lapor tanggap tidak	negative
investasi aman janji	positive
aktif trading aplikasi kembang baru keep up aplikasi depan ya	positive
ya suka	positive
manfaat cocok mula	positive
senang mudah	positive
transaksi mudah sukses nanovest	positive
ya akun nanovest batasibahkan salah apa akun batas rugi karena login akun beli aset tunda	neutral
kasih bintang dulusoalnya nyobananti kalo hasil puas bintang	positive
mantap moga calon orang indonesia	positive
afk bagus	positive
rawr	neutral
simpel praktis investasi	positive
mudah	positive
banget nge acc ccd parah aplikasi	negative
tarik duit seabank gagal truss	negative
top up lancar moga transaksi lancar bintang	positive
aplikasi bagus mudah cuman naik turun harga cepat beda	neutral
ok lambat so far	neutral
moga nanoves depan	positive
aplikasi bagus top up tarik saldo gratis rekening bank sinarmas rekening sinarmas rasa lelet	positive
tolong akun enggak masukinudah coba emailnikpin enggak masukcoba bantu enggak fungsi	negative
mudah cepat moga aman	positive
subhanallah	positive
moga depan	neutral
replek bos mantap	positive
selamat pagisaya enggak masuk akun sayasedangkan akun saldoterima kasih	neutral
proses transaksi cepatnanovest luarbuasa	positive
top up	neutral
enggak bagus aplikasi	negative
henti tibatiba konfirmasi password bantu name tag	negative
mari coba	positive
kasih duli lo bagus	neutral
aplikasi investasi baik orang	positive
mantul tha mazeee langsung sat set tha mazeee	positive
cantik	positive
bagus banget inves kecil alhamdulillah investasi ribu hasil ribu alhamdulillah bangetrezeky anak keluarga enggak masya allah bangetdan enggak sangka bngetpdah inves limit bisa dapat gede masya allahinves rbnano vest hatikata bang rigen juga wkwkendors bang rigen ya kakatau kak chateezaku tau nano vast dari wkwk projek masya allah suka banget bang rigen endorsapa lagi chateezcba kak endors kak chateez	positive
pakai erti	positive
aplikasi bagus mudah paham ya metode tari uang ditambahin	neutral
download aplikasi gara dapat minyak gula sudah didaftarin les data masuk pakai ktp no tlpn tau dapat minyak ltr bilang dftr lagi bir dapat minyak heleeeh lansung uninstal plus blokir	negative
kerja bikin kecewa email laku kyc masuk email pikir hapus akun selesai kecewa	negative
tambah bot investasi ganda keren	neutral
mantaap	positive
order sahamudah dapat sistem no rekomended	negative
buruk jual investasi enggak sesuai potong pikir pikir kalau download teman teman	negative
aplikasi busuk download ganggu sistem	negative
turun lengkap mudah mula	positive
sulit verifikasi akun baru kycnya hasil perintah tunggu proses tunggu perintah ulang tolong baik	negative
moga lancar	neutral
sesal pakai enggak hapus akun bot enggak	negative
mantap jamin aman data	positive
asyik	positive
kecewa enggak tau tri aplikasi kagak range harga asli nanovest banget baru harga detikmenit contoh gua btc harga rp m harga asli kalau aplikasi rp m pas beli satoshi pas lihat riwayat transaksi beli harga rp m buset harga asli sisa bagus uiux ramah tolong tambah fitur trading coin listing	neutral
keren sih enggak rugi aplikasi	positive
coba mudahhan amin	neutral
kasih fitur tari pakai dana pakai bank biar enak begitu mohon kasih	neutral
lupa masukin refeal remoo	neutral
salah aplikasi investasi komplitsimplebanyak pilihanterutama cryptosemoga koin beli	positive
bagus nanovest cepat mantap murah baik	positive
saham us crypto lengkap grafik tidak lengkap tidak lengkap aplikasi asal saja	negative
ok banget	positive
wow	positive
dapat nbt token isi referal gala daftar	neutral
enggak masuk	negative
apps bagus	positive
opsi top up via shopee hilang bank bca enggak opsi	negative
erti	neutral
okay	positive
foto ktp kaya bagaimana sih sudah pencet teken ktp sudah enggak susah banget login saja l	neutral
bagus paten	positive
download karena lihat bocah kosong enak kalau mula invest basis nabung uang jajan topup pakai uang sisa jajan minat coba guna mudah tau kalau jual saham nunggunya hari pasti tapi oke sih	positive
simple murah kualitas ok	positive
jalan top up mudah moga depan kembang aman lancar terima kasih nanovest	positive
keren mula mudah langkah	positive
bagus tampil oke saran kripto apps nanovest kritpto worldcoin wld nanovest	positive
bintang alhamdulillah akun berkat bantu tim nanovest sabar invest	positive
coba investasi pakai nanovest yuk daftar pakai kode referral lindsayhi	neutral
simple proses transaksi cepat	positive
cepat jual cepat cair	positive
bagus sihhcoba spill transfer nano bank	positive
bismilah coba moga lancar	neutral
kode otp enggak kirim banget nunggu	negative
nanovest keren	positive
appk recommended bhrobeli coin nbt stakesetiap coin nbt bertambahsemoga tahun nanovest jaya	positive
ajar dulu	neutral
bagus murah trading saham beli rp	positive
bagus	positive
janji	positive
apka buruk enggak pakai enggak	negative
verifikasi email email masuk ganti email masuk pesan email	negative
asoyyy	positive
cepat beli kripto cepat mudah akses aplikasi nanovest bravo tingkat menu layan	positive
moga bagus	positive
baik	positive
well	positive
masih mula	neutral
baik	positive
verikasi ktp data salah sistem tolong baik	neutral
salur whatsapp biar gampang info real	neutral
saran saja metode tari mudah tambah dana narik simpelmasa topup dana narik dana enggak	neutral
pas tari pin salah pin sudah ganti pin pin salah tunggu jam nanovest tipu scam aplikasi abal abal kecewa	negative
bagaimana verifikasi kalok email saja enggak kirim	neutral
overall bagus informasi sedia upgrade ya	neutral
moga untung	neutral
harga playdapp sesuai coin market cap beda kak tolong baik kak rugi kak	positive
bagus	positive
sep	positive
bantu mmbeli crypto	positive
mantap tap	positive
bagus gampang erti mula mudah enggak ribet tolong bikin alert harga emas kaya alert harga kripto terima kasih	positive
tolong adakan feature limit order cryptosegera	neutral
ok bagus aplikasi tolong aplikasi upgrade kayak statistik dll biar tarik kalah aplikasi p	positive
this is good application for investation with digital system	positive
senang saya investasi nanovest mudah mudah untung	positive
ajar moga lancar	neutral
coba beli saham cripto enggak untung sekaliyg potong	negative
iya	positive
investasi baik	positive
moga untung guna	positive
bagus aplikasinyacuman sayang sprednya gede tau vi	neutral
bintang dulu dechfitur aplikasi mudah paham mula berinfestasi moga kembang sukses nanovest	positive
sangat bantu	positive
mudah transaksi	positive
aplikasi percaya sdah daftar terus investasi akun kunci chat csnya bla bla kecewa	negative
transaksi senang mudah	positive
moga kecewa	positive
kalo akub ambil orang data data aman enggak bos	neutral
okok feksua karamai fukaaa	positive
cepat asli gila proses canggih enggak ribet pakai	positive
akun sudah hapus enggak pulih	neutral
alangkah baik alert nominal harga	neutral
overall ok banget pas sudah pakai tambah result search alt coin beli enggak ondo contoh	neutral
mantap enggak potong tabah metode tari ewalet dana dll	positive
investasi bagus cair saja cepat masuk cari orang cepat proses mudah free nbt gbnano daftar suka jual aset enggak mesti nunggu hari minggu minggu jual tarik rekening langsung masuk	positive
logout mulu susah main	negative
daftar	negative
good	positive
verifikasi email	negative
aplikasi bagus rugi sukses maju terima kasih	positive
moga	neutral
mudah erti	positive
mudahn amanah cepat proses	positive
tida buka	neutral
dikit moga bukit hehe	positive
kyc enggak masuk email lo apa	negative
mantap banget cocok banget mula anak muda aplikasi gaul ayo gesss bantaiii	positive
moga lancar	positive
bagus cuy	positive
moga baik	positive
ajar biaya murah riah	positive
bagus mudah terpecaya	positive
lumayan bagus lihat take profit buka satu transparan portofolio kalau take profit transparan	neutral
joss memang namovest	positive
proses kyc gagal mulu ya benar	neutral
niceeee aplikasi	positive
oke	positive
mantap	positive
enggak hubung bank ya nomor rekening tuju bank nama sesuai nama akun nanovest tolong kendala situ	neutral
mntul	positive
keren langsung beli rioyoogas langsung coba ini bro auto cuan	positive
best	positive
transaksi cepat	positive
wokeh	positive
ok mantap	positive
bagaimana gua lembar saham usaha auvi ribu hilang sekaliii tolong bagaimana	negative
good aplikasi	positive
paham fleksibel ajar	positive
salam sukses	positive
mula paham	neutral
praktis mudah mula	positive
aplikasi golong mudah paham cuman sayang enggak bid offer enggak leluasa beli harga contoh harga terus buy dapat otomatis an saja minus	neutral
coba	neutral
mudah investasi	positive
overall bagus result kolom search saham batas tampil hasil cari kadang kadang cari saham sulit batas search result update tolong search results batas hasil cari tampil saja kritik saran moga nanovest kembang	neutral
mantan lur coba	positive
jujur umur ajar trading sayang syarat daftar minimal umur	negative
ayo ramairamai beli nanovest token	positive
mudah mudah paham bintang	positive
ira tari pakai ewwalet eh top up doang pakai ewwalet tari bank hadehhh	neutral
bagus	positive
tukang kayu	neutral
baik suka	positive
coba pakai aplikasi nanovest moga depan update nyaman guna penuh	neutral
susah narik ung ribet gagal terus alas banyak tayi enggak aplikasi	negative
biar aplikasi aman sandi buka aplikasi contoh indodax aplikasi mobile bank	positive
okeeee	positive
mantap aplikasi	positive
update ya	neutral
mantap banget aplikasi nanovest	positive
bagus mudah guna	positive
moga sukses nanovest	positive
enggak fitur tarik uang pakai aplikasi dana susah kalo bikin kartu bank	negative
aplikasi enggak akun ganti no hp email sudah begitu enggak pemberitahuan email hati hati saja aset	negative
mudah paham mula	positive
ketik nanoteg eror mulu memang ketik	negative
fast	positive
aplikasi cetak okb keren	positive
akun tahan nanovest tapi cs daya hapus spend money kecewa akun enggak bisa diidupin ganti nomor	negative
mantapterbaik	positive
minggu verifikasi ktp	negative
mantap	positive
install aplikasi moga depan sukses kembang kait lupa quality control aspek	neutral
informasi tarik orang	neutral
moga cuan aplikasi amin	positive
jelek servernya ngebug lambat delay kalau event	negative
harap jadi ter ulang	neutral
ragu investasi saham nano sempurna	positive
tolong ui bagus opsi ganti foto profil tolong update	neutral
buy sell langsung posting tutup begitu takut uang rugi turun buy langsung jual begitu	negative
aplikasi sudah bagus fitur stop loss take profit begitu kayak bagaimana ya masak buka appnya lihat profit begitu take profit stop lossnya jadi notif user user sudah stop loss take profit saja bagus mudah erti	neutral
mudah pakai	positive
aplikasi bagus invest	positive
lihat	neutral
harap baik	neutral
terima kasih	positive
ya sudah mantap	positive
coba aplikasi bagus mudah fahami cocok mula ajar trading terima kasih	positive
senang	positive
id darussalam brandanya gampang erti rekomen banget mula	positive
erti	positive
praktis cepat	positive
ajar hu	neutral
biar bintang bicara	positive
bagus coba mudah sesal enggak coba nanovest terima kasih	positive
bagaimana kerja kak tolong kasih tau	neutral
kehh	positive
cair saham soalna sudah jual saham enggak masuk saja	negative
tari ewalet	negative
perhati ya review lainnyamasalah akun batas perangkat rentan ganggu aman nanovest harap hapus aplikasi bahaya setel ulang atur ganti perangkat mu live chatdi anjur ganti hp reset pabrik ganti hp setel pabrik kendala mana hp install apa buy langsung akun batas indikasi cut lost delisting bottom	negative
moga sukses	positive
juang	positive
mantap	positive
cuan cuandyor	positive
senang pakai nanovest	positive
bis anak usia	negative
tampil menu mudah	positive
mantap banget	positive
bismisllah sukses	positive
bagus banget informasinyatolong tambah tombol harga buy sell manualjadi pasang buy sell sesuai keinginanmksh	positive
aplikasi ya ganggu	negative
hadiah referal misi sulit pajak tolong baik	negative
verifikasi kyc tungguin email kagak masuk sudah berulangkali juga	negative
biar bintang bicara	positive
ok mntap coba	positive
kalau nomer hp hilang bagaimana login	neutral
bismillah moga aplikasi bagus	positive
mudah paham	positive
tolong sedia tombol batal sudah order jadwal enggak dibatalin jam jadwal	negative
tolong tambah candlestick chart	neutral
sangat bagus anak mudah investasi apliaksih inj	positive
potong kalo rugi adeh capek	negative
deposit lancar beli lancar gilir wd proses gagal wd iki pie tapi	negative
oke spread kecil kalok	positive
lihat ulas positif tanggap	positive
aplikasi judi bagaimana dah take profit ski eh yang rang sekian terus feenya gede banget	negative
aplikasi bagusaksesnya mudah susah login jaring stabil coba updatesaya coba uninstall install ulang baik sistem ya	neutral
aplikasi bagus banget	positive
proses yahuut	positive
investasi nanovest simple keren	positive
puas	positive
aplikasi mudah mula	positive
cocok mula ajar investasi kripto saham nanovestgreat	positive
install setting bagus beli saham luar promo uinya mudah erti tapi kadang suka berat ya sisa okey coba investasi	neutral
nanovest baik	positive
investasi modal tenaga wacana kirakira ulas sesuai aplikasi	positive
hai iwan setiawan buruh hariyan lepas senang tema kawan semuwa	neutral
ui enggak pusing	positive
simple	positive
aplikasi loading stuck masuk mohon baik	negative
aplikasi lumayan bagus puas hasil saya coba kembang	neutral
bintang tau hasil aplikasi memang enak akses	positive
investasi baik aman terpecaya cocok investasi jangka	positive
mudah gunakancocok mula	positive
kok enggak buka apkk	neutral
cair dana account ebanking lambat amet	negative
coba investasi	neutral
parah coba beli asset saham proses banget acc batal pending terossss	negative
semogah layan proses transaksi konsisten selam manfaat membernya	positive
nanovest aplikasi investasi crypto untung sudah wd depo cepat	positive
mantap nanovest	positive
puas	neutral
mudah erti simple	positive
aman nyaman investasi	positive
gandos mudah percaya	positive
bagus transaksi pakai biaya	positive
aplikasi bagus invest sarantambahin metode tari e wallet	neutral
sukses nanovest	positive
kesalll muncul enggak renti hp anak sayagimana blokirnyagara anak saya download game enggak tau game menit ganggu	negative
bagus aplikasi beli transfer mudah	positive
aplikasi lambat ngebug tolong baik	negative
enggak upload ktp	negative
the best investv	positive
simple aman cepat gila	positive
coba ah	neutral
iklan terusmenerus jedah lama pikir orang	negative
mau daftar baca review top up juta terus akun terkunciwoh bahaya	negative
modal dulu moga konsisten	positive
tolong beritahu bagi dividen email notif aplikasi biar tau lebih sudah oke	neutral
beli saham crypto beli saham non crypto	neutral
aplikasi bagus enggak verifikasi kyc coba bas gagal ganggu	neutral
sampah kere reward cancel bintang perusaaan	negative
baik	positive
aikoh bagus banget aplikasi	neutral
susah login	negative
bantu bintang tanggal desember	positive
tolong tambah fitur marke order crypto grafik ganti candlestick tambah aplikasi desktopnya	neutral
tolong tari uang ewallet dana	neutral
nice kendala aku terlogout bagus aman	neutral
sehat	positive
sistem top up eror top up dobel nasabah rugi eror tari ya	negative
enggak narik saldo dana kalo ewalletlebih mantap	negative
tolong tambah fitur kirim terima koin shiba inumasa bonk listing kirim terima lainsementara koin shiba bisaitu terima kasih	neutral
aplikasi percaya	positive
tolong hapus data saya akun ambil orang	neutral
kasih bintang ta coba kalau bagus	positive
aplikasi bagus mudah erti mula fiturnya minim tolong lengkap fitur transfer hot wallet candlestick chart	neutral
aplikasi bagu cuman verifikasi email enggak email masuk tampil buka email tapi spam email du buka enggak verifikasi tanda darurat tolong baik	negative
pakai beli saham amerika	positive
mari tabung investasi saham	positive
untung masuk referal dwikidama	neutral
coba	neutral
verifikasi email sulit	negative
aplikasi keren mula	positive
masih dalqm sipahami	neutral
halo bikin alarm nanovest notifikasi layang pesan masuk coba setting hasil beli jual saja notif kasih izin notif nano aktif saja enggak notif alarm notifnya aplikasi nano	neutral
aplikasi lambat banget saham butuh beli saham pluang sat set enggak heran nano kalah sama pluang	negative
tari via ewaled dana ovo va sedia	neutral
kualitas bagusaman percaya teregulasiberizin perintah	positive
aplikasi buruk top up pakai dana ovo nyairkanya pakai bank kecewa	negative
adq kode referal enggak kak downlod	neutral
mantap	positive
enggak tarik dana nama bank bedadana nyangkut	negative
mencobasemoga bagus	neutral
aplikasi lambat lambat	negative
aplikasi keren investasi	positive
sudah ok edit	neutral
ok alam guna	positive
tampil oke tarik animasi aplikasi jalan cepat	neutral
mudah beli jual	positive
ok sayang saham as regulasi indonesia	neutral
bintang belum tau kayak mana mksut	neutral
coba moga hasil	neutral
investasi biaya transaksi biaya broker sesuai biaya tari bagus investasi untung ratus rupiah dalam	neutral
nabung dikit dikit	positive
saran tampil jadi pro real time enggak resfresh app	neutral
pas top up gampang mana withdraw susah ribet mohon baru vitur tari uang	negative
rekomendasi bang raymond moga invetasi	positive
aplikasi bagus ktp	neutral
mula coba invest btc nanovest modal minim terima kasih nanovest	positive
tampil oke fitur oke tingkat cepat	positive
nanovest bagusdan ribet maju nanovestyes yes yes	positive
ajar trik biar aplikasi manfaat	neutral
giod	positive
aplikasi investasi bagus	positive
kasih bintang bebas delisting bintang sudah lengkap tanggal ex dividend saham tanggal bayar dividend saham	positive
fly higher	positive
top up mudah ewalet	positive
aplikasi bagus berat foreclose aplikasi gede enggak foreclose kayak ml shop ig bibit dll tolong baik ganggu nyaman guna	neutral
tombol gelembung live chat enggak versi baru tolong baik	neutral
very excelent apps lengkap bahan analisa ambil putus investasi digital thanks nanovest	positive
aplikasi bagus simpel enggak ribet	positive
moga bantu	positive
maaf ulas ralat karena sadar	negative
bintang dulu kurang kalo coin enggak aplikasi bome sudah lumayan	positive
keren	positive
cepat mudah praktis bagus moga nanoves kripto saya cuan terus amin	positive
mula	neutral
good luck	positive
susah banget login akun ya	neutral
mudah	positive
aplikasi kagak akun orang maendi bane gjls	negative
aplikasi bagus	positive
keren	positive
insy allah cuan	positive
get out sendirigimana nihsorry star saja ya	negative
bagus mula	positive
bagus cocok mula fitur mudah erti	positive
haloboleh daftar nomer telefon negerimisalnya malaysiasingapura laku domisili indonesia mohon dijawapnanti bintang hehehee terimakasih tanggapannyabtw bintang yasemoga nanovest sukses	neutral
gandos	positive
ya begitu ya untung untung untung hasil	positive
oke	positive
so far so good	positive
bagus nanovest cuma kurang enggak ambil withdraw dana coba bintang mohon fitur withdraw dana ovo terimakasih	positive
anjrit gue sudah narik uang ini progress anjir sudah masuk rekening sudah ngehubungin cs suruh nunggu pemberitahuan email enggak	negative
login nomor hp enggak kirim kode verifikasinyasdh coba kali loginpikir kalau investasi	negative
verifikasi email sekalisaya ganti email	negative
mes susah kyc	neutral
permisi admin harap untuk bertransaksitransaksi ya ewallet danatrima kasih ya perhati	neutral
mudah tampil tarik	positive
aplikasi bantu kalian daftar grezly kalian uang tambah	positive
arigato nanovest	positive
percaya aman cepat proses wd	positive
tolong akun akses jangan jujur kecewa sudah hubungin respon cuman kaya begitu	negative
ajar tau	positive
cepat masukin token token woi	positive
nanoves keren banget aplikasi beli saham crypto nyaman mudah	positive
harap tari dana aplikasi tdak bank	neutral
fiturnya lengkap persen dividen bayar lihat broker fitur nanovest	negative
aktifin akun hapus bagaimna ya	neutral
tari rekening bang ribet	negative
parah akun batas aplikasi enggak	negative
mksih sudah asih jalan investasi	positive
aplikasi ampasrefferal beku alasancs shortcut sudah dibuatmasih percaya aplikasi begini	negative
menciba	neutral
kyc gagal bagaimana foto ktp milik pribadi enggak	neutral
good pokok	positive
simpel lengkap	positive
beli koin crypto proses cepat lebih beli harga coin sisa kembali nanovest oke	positive
smart order	neutral
suka nano vest aplikasi keren banget trim	positive
ok	positive
aset crypto menu beli jual	neutral
keren nonovest beli lancar bnb	positive
good	positive
tambah fitur download dokumen isi data beli saham crypto dokumen diagram data dari nanovest alpaca biar gotrade begitu terima kasih	neutral
weih cepat mantap cuan	positive
ajar mudah deskripsi produk	positive
minimal usia sudah ktp enggak login	negative
halo saran tambah take profit otomatis stop loss biar lengkap overall aplikasi bagus	neutral
suka beli investasi mudah gampang	positive
nanovest oke pakai banget	positive
mantap enggak ragu percaya bonus untung	positive
koin segitugitu saja enggak rugi	negative
mantap ui aplikasi nanovest terbaique moga nano coin harga ya	positive
invest bentuk saham ribetnggak toxyk	positive
tombol verifikasi email sentuh	negative
tolong menu tarik uangsaldo tarik akun dana	neutral
coba	neutral
stake nbt pas claim buka tambah payah tipu	negative
mantap	positive
tolong baik akun akses akun batas guna padahal rugi nanovest tolong baik	neutral
detail	positive
csnya mantap fast respon	positive
bagus aplikasi	positive
data pribadi ambil tipu tolong bantu terima kasih	negative
maaf asih bintang withdrawal ewallet danaovogopayshopeepay moga segera tari ewallet	negative
mudah inves	positive
apknya bagus murah uang mending beli sahaam ai gua tahin ai hidup nyata saran developer tolong tambah metode top up via pulsa xl xsis telkom dss karena orang sisa pulsa pasca beli paket data	positive
up	positive
aplikasi keren	positive
kalau download aplikasi kalau rekening enggak tuker ewalet admin nanovest gerak lambat baik kalau tarik pakai ewalet mudah	negative
tari uang aplikasi genflix mudah cepat terimakasih nanovest	positive
tingkat kualitas layan nyaman aman nasabah	neutral
bagus mudah ajar	positive
bismillahirrahmanirrahim moga profit	positive
aplikasi bagus lengkap patut kasih bintang	positive
aplikasi update versi baru	negative
bagus banget bos	positive
verifikasi ktp foto verifikasi email sudah oke aplikasi verifikasi foto ktp ambil foto	neutral
kak kenpa sekarang total jualbeli klaim ribu capai juta kak terus bagaimana cari orang dapat ribu klaim	neutral
jaring enggak lancar nanovest lancar	negative
ribet kycnya	negative
penipuanpembajakanpencurian identitas	negative
mantul enggak ada lawan pokok mah	positive
aplikasi bagus	positive
made pokonamah moga	positive
moga acc	positive
layan buruk wirtdrawal masuk aplikasi refund bisadengan alas complain aplikasi kirim crypto tersebutkata agen nanovesthilang sia ribu nyesal pakai aplikasi guna	negative
aplikasi nanovest mudah user mula tarik deposit cepat mudah	positive
salah aplikasi investasi jangka percaya aman mudah dijalankannafizahannidia undang lupa kawandi tulis kolom isiundangan pakai aplikasi mayanlah dpat hdiahnya loh aplikasi cocok suka investasi usaha usah nama gogle appel dll aplikasi izin otoritas jaza uang ojk enggak ragu	positive
tangan	negative
dyrudyr resuiti cyeyduyi hitbfdscom ohygim gyrsyeysu	neutral
senang	positive
tahap coba	neutral
pitur pitur mudah paham	positive
investasi biaya transaksi biaya broker sesuai biaya tari bagus investasi untung cuman ratus upiah dalam	negative
moga manfaat nyimpan duit	positive
nice app	positive
foto e ktp nanovestkok sulit banget posisi pas iya susah regritasinya	negative
mudah	positive
mantap nanovest ajar	neutral
cool	positive
isi saldo cepat puas	positive
iklan	negative
alhamdulillah	positive
kycnya susah hapus install clear cache pakai gmail no hp enggak kyc izin aplikasi nanovest bagaimana	negative
investasi bagus banget banget investasi jangka panjangset slesai tinggal nikmat hasil main kripto saham reksadana pilih saja cocok mana moga manfaat mendownload coba	positive
puas aplikasi	positive
aplikasi simple moga berkah masukin kroco	positive
bagus ya	positive
log out	neutral
coba	neutral
mantap aplikas guna investasi	positive
bagus investasi cuman saran tari duit narik duit ewallet bank saja kadang ngebug aplikasi login sudah pencet tetap delay login saja tetap aplikasi kadang delay jaring lancar	neutral
buka lihat hasil eh suruh verifikasi kyc jadi ragu kalo verifikasi	negative
mantap mudah erti	positive
tanyaa sudah awas ojk kah terus beda sama bappebti	neutral
love itu	positive
antap	positive
aplikasi user friendly banget saham jadi investasi cryptonya pilih moga imbal hasil staking dailynya nano depan hehe	positive
mula gue ajar	positive
aplikasi keren banget bantu mudah beli koin krypto	positive
fee biaya splitselisih harga jual beli mahal trading	negative
mudah bagus	positive
tampil rumit simpel	neutral
jelek layan aman pula	negative
fitur chat ya biar diskus ok	neutral
moga nanovest sahamsaham indonesia beli	positive
coba uji	neutral
yeah	negative
alhamdulillah kaya	positive
jelek ya pakai aplikasi tarik uang biaya transaksi akai bintang karena aplikasi mahal	negative
saran keritik alam pakai aplikasi puas banget pakai aplikasi banget kurang nya aplikasi kripto jelasin kripto a buat produksi hasil berita tetang sih kripto banget enggak auto order cuman alert saham enggak jelasin terang dividennyah semacamnyh enggak a	neutral
lumayan mudah akses	positive
aplikasi mudah erti	positive
tari ewalet danaovo dll	neutral
moga fitur charting biar gampang analisa teknikal	neutral
keren	positive
nanovest aplikasi beli saham nyse erti orang satusatunya aplikasi non cfd indonesia kurang chart delay fitur live chat aplikasi bayang kurang baik bagus nanovest	positive
mudah dipahamiaman	positive
enggak ribet mula trading mending beli saham kripto	positive
investasi nanovest	neutral
parah kecewa banget enggak sesuai iklan aman simpan duit uang hold hilang jadi akun enggak kaget nyimpen lagi langsung hapus akun enggak percaya lagi iklan artis	negative
ok coba dulu	positive
kayak scam beli mahal grafik murah jual murah dari grafik enggak main begini untung rugi	negative
enggak tarik saldo bank jago nama ktp aplikasi buruk	negative
app nanovest bagus	positive
bikin multi mining produk mlm nano coin	neutral
nanovest ajib	positive
aplikasi mantap	positive
game ya bagus	positive
maaf code pin bagaimana ya tolong bantu terima kasih	neutral
bantu	positive
operasi berat proses tampil aplikasi	positive
okeee	positive
bonus	positive
iklan ganggu	negative
invest moga tahun apps	positive
referal robiauto tinggal salin saja	neutral
keren cepat proses beli crypto	positive
user interface friendly	positive
pas ngisi data enggak email masuk ya verifikasi enggak daftar	neutral
halo nanovest apknya akun aman haruskeluar login ulng bagaimana atasinnya	negative
oke banget	positive
mantab tenan	positive
awam	neutral
aplikasi bagus respon ya cepat mudah erti kasih bintang muas kan	neutral
coba inves eh email gue enggak masuk tahi download	negative
mantull	positive
bagus beinvestasi nanovest download coba investasi nanovest coin	positive
langsung kasih bintang appk nanovest blum joba	positive
sukses	positive
oky	positive
mudah paham force closed	neutral
bintang bicara	positive
baik bagus aplikasi enggak rasa sudah suka banget pakai aplikasi uinya bagus fitur bursa gue invest crypto gue enggak pakai aplikasi langsung good job nanovest ubah bintang kritik realistis saja bagus bagus enggak ya enggak	positive
pas tag unik enggak masuk	neutral
aplikasi keren banyak eventx	positive
mantafff	positive
simple edukasi	positive
mantap mudah erti paham ajar sama	positive
anji	positive
mantap top up enggak biaya admin	positive
mudah saya pakai nano ves	positive
bagus	positive
gampang paham	positive
mohon info uang bisa cair ojk kantor polisi mohon bantu administrasi	neutral
cepat transaksi	positive
gue sudah daftar akun gmail gagal mulu enggak masuk anjir jam cek tetap saja gagal	negative
ning investasi darpada slot	positive
mudah mula	positive
aplikasi dukung invest	positive
enggak masuk bikin tag katax kendala jaring begitu terus	negative
aplikasi tambah aset	positive
tolong sedia auto sell	neutral
coba ya	neutral
ajar	neutral
profit	positive
mantap biaya	positive
ganggu ya mohon maaf kecewa tulis akun batas enggak kendala niat jual rit bagus eh enggak turun invest kripto ngandalin rit jual mohon erti kendala aplikasi hp rena hp beda merek tipe coba hasil perangkat bahaya	neutral
mudah	positive
transaksi instan enggak ribetnya	positive
enak	positive
coba mudah itumoga lancar investasi uang receh	neutral
bagus simple	positive
tim nanovest user saran tambah fitur jual otomatis sesuai target profit patok rating bintang minta penuh orang tuju usul terima kasih	neutral
pengin coba inves platform bagus bisa dari nilai mula	positive
dukung	positive
smart market	positive
moga kaya	positive
aplikasi bagus gabung pasar saham kriptodalam mudah satutempat aman cepat laku	positive
good krypto aset	positive
coba kaya	neutral
moga enggak bangkrut	neutral
nyobasemoga	neutral
moohon bntuan tidk upload foto padahal sudah ktp live chat enggak hp aneh kalau ancar kasih bintang	negative
aplikasi bagus	positive
simple mudah berinvest mula	positive
iyes	positive
bintang saja coba kalo cuan bintang poll	negative
mantaap	positive
ajar trending	neutral
kurang customer servicenya lambat slow respon	neutral
mtnano mantap pokok nanovest	positive
oke banget rewards	positive
mantap staking staycool	positive
bismillah	positive
mudah mudahn cuan	positive
bagus ajar investasi	positive
bagus aplikasi gampang moga untung kali idevenden	positive
coba dulu hihihi	neutral
mantap nanovest sukses	positive
nanovest mantap beli emas dukung brand terpecaya	positive
bagus	positive
gua suka nano banding proses cair cepat cepat transfer bank mantap depan tolong gratis biaya cair rekening bank joosss	positive
banyak reward	neutral
kelaszzzz	positive
tolong bantu biar orang sukses	neutral
ragu bimbang pakai nano vest insya allah aman	positive
aplikasi investasi kemas baikdengan ui ringan mudah erti mula sayasaham serta crypto bungkus pisah mudah guna transaksi terimakasih nanovest aplikasi simpel mudah dimengertisukses nanovest	positive
easy save the best	positive
bagus investasi moga manfaat orang	positive
perfect	positive
mantap tambah hasil	positive
mantap bagus	positive
nice	positive
nanovest baik dukung exchange indonesia moga kembang tolong balas keluh customer ya terimakasih	positive
mantaf	positive
so far so good	positive
bugagak susah cuan exchange iniestimasi untung enggak sampai pas jual	negative
lancar	positive
tahun ragu beli	neutral
aplikasi mudah paham	positive
moga manfaat	positive
tutor main dong	neutral
bintang bicara	positive
coba kalau bagus bntang lagi	neutral
nyaman tabung jangka	positive
wd saja susah pakai faktor googlestelah dimasukin kodesalah aplikasi layakjg investasi disinirumit	negative
coba lancar kasih	neutral
lag parah	negative
mantap mula hasil nyata aman	positive
lancarorang ngeleg mulu saja daftar unistall saja	negative
zat xmz zn	neutral
gampang operasi transaksi cepat	positive
coba	neutral
hello admin transaksi jual beli saham benar konifmasinya adeh bukin kesel investasi	negative
mantabbb	positive
mantap	positive
biaya app free sistem enggak realtime dari segi harga beli jual untung margin situ app transparan dari offer bid sell buy	neutral
tambah info fundamental usaha saham us nanovest buka konversi usd rate	neutral
ganggu iklan	negative
tarik iklan bosan erti	negative
tolong tambah fitur limit order aplikasi binance indodax	neutral
alhamdulillah akun sudah login kemarin batas ya perangkat aplikasi bahaya sudah aman nanovest moga depan sukses	positive
top	positive
ui friendly mudah transaksi tapi minus baca chartnya enggak candlestickitu saja benar	neutral
aplikasi bagus	positive
verifikasi apikasinya	negative
is the best	positive
mohon maaf tolong baik ya karena bug baik karena menggangu	neutral
bagus bantu kirim mudah cepat enggak ngecewain	positive
yes	positive
aplikasi berat	negative
kalau enggak salah aplikasi orang amerika serikat ya	neutral
the best	positive
depo enggak ribet sip mudah pas wd enggak ribet enggak potong	positive
loading aha susah parah	negative
ok recommended	positive
mantap aplikasi bagus	positive
fine saja cuman belum paham saja system	neutral
terimakasih inspirasi investasi jangka	positive
bagus recomended	positive
great	positive
sekian coba investasi mudah senang semenjak aplikasi nanovest userinterface mudah paham tampil sederhana tempat fitur erti bajar incestasi update bertita pasar baru tahan nano moga guna	positive
god job	positive
aplikasi bagus	positive
semenjak pakai aplikasi enggak ragu karena aplikasi sngat percaya id undagannya kawan aplikasi mndapat izin awas otoritas jasa uang percaya mendpatkan izin pengguanaan uang elektronik aplikasi salah aplikasi tanam saham aman nyaman pakai	positive
apknya berat	negative
aplikasi bagus banget misi rewardnya	positive
refferal adarayas	neutral
verifikasi email	negative
good for my invest	positive
nanovest aplikasi investasi tunjang khawatir ekonomi butuh bantu nanovest saham terimakasih moga aplikasi nanovest selalu kembang pesat aplikasi nomer dunia	positive
moga sukses amin	neutral
cobacara investnya mudah	neutral
tarik uang ribet	negative
aplikasi lambat	negative
loved	positive
aplikasi mu buruk akun sudah suruh ngisi pin admin bego bikin pin admin aplikasi harap baca ulas	negative
coba untung ajar nih aplikasi moga saja rejekinya aplikasi	neutral
tolong investasi nabovest rp laku kasih	neutral
guna ygy	positive
puas beli saham mula	positive
aplikasi top markotp pitur limit order top	positive
apknya berat update harga lambat moga tingkat	negative
bagus	positive
silah teman ekappp	neutral
keren habis mudah paham mula investasi mantaapppp tingkat limid order buy sell saham terimakasih	positive
good aplikasi	positive
tolong baru aplikasi sudah minggu coba konfirmasi email eh enggak	negative
mudah transaksi	positive
sungguh praktis aplikasi kemas tarik e walletsahamemascrypto perfect	positive
bagus jadi investasi ain	positive
bagus banget tanya beli btcnya mahal untung cepat saja	positive
verifikasi email muter muter doang	negative
bagus all umur	positive
coba investasi aplikasi	neutral
bagus mudh paham mula saya	positive
sangattttttt	positive
aplikasi ok gratis mantap	positive
hibur	negative
mantap top up langsung masuk cepat banget oke banget	positive
proses depo wd cepat	positive
aman enggak dukung samsek akun hapus aku main kotor pakai reveral	negative
beli saham us murah	positive
admin top up enggak	neutral
paham kah bantu	neutral
recommended	positive
aplikasi investasi kikemas baikdengan ui ringan mudah erti mula sayasaham serta crypto bungkus pisah mudah guna transaksi terimakasih nanovest aplikasi simpel mudah dimengertisukses nanovest cantum tulis b e r kah akun aktif ya	positive
mantap mas bro keren tari cepat bosque	positive
pengin coba klou benar saldo tambah kaslima	neutral
bagus tanam saham	positive
enggak verifikasi email	negative
oke mantepp gampang	positive
bagus	positive
coba	neutral
layan buruk coin pending enggak jual witdraw tempat enggak terima rugi harus coin caspen otomatis jual coin hapus rugi habis	negative
suka banget mudah guna	positive
aplikasi enggak jaring bagus bagus tapi login susah	negative
sudah bagus benar beli harga beli catat beli harga	neutral
aplikasi	positive
susah verifikasi enggak	negative
mudah paham nyicil saham negerimantap	positive
bagus tari riltime	positive
enggak pesan masuk verifikasi gmail	negative
ok saja	positive
bantu	positive
mudah simpel cepat aman	positive
sempurna aplikasi berat banget loading hape ram gb ya enggak tau kalo ram	neutral
aplikasi tidak buka ganggu kenapa ya saya tidak cek saldo cripto	negative
tarik tunai nama akun ovo nanovest loh enggak kerja bagus	negative
terimakasih benar hasil	positive
jelek gue wlw aplikasi userfacenya bagus dapat untung stake tapi portofolio gue habis gue invest sengaja dkit lihat performnya bikin rugi melulu tanggal hanpir hilang mending treasury nabung emas sono dapat untung lmayan trunnya juga enggak sampai habis kayak begini	negative
moga berhasilaamiin	positive
moga pasu target operasi kecewa bismillah mau invest receh pelan moga gacor kangv entar kalo bagus kasih bintang langit	neutral
lupa masukin ref dims biar dpet bonus	neutral
ajar	neutral
ok moga harga biar milyadermantap jaya nanovest is the best	positive
ganti mm orang beli lipus kupang	negative
aktif kyc email masuk coba ulang minggu	negative
mantab	positive
nice	positive
moga manfaat a	positive
mula	neutral
apknya bagus mudah erti bisa top up via walet kurang belum bisa narik walet	neutral
kasih ya mula	positive
terimakasih	positive
belum pecah telor	neutral
ada forex biar keren nanovest entar kasih bintang	neutral
try	positive
tahan sistem bagus	positive
nano cocok investasi	positive
halo akun kunci ya	neutral
oke mantap	positive
belum paham aplikasi nanovest harap saya aplikasi nanovest bantu rubah hidup sejahtera	neutral
gabung ajar tradinh martked	positive
kalo kasih grafik teknikal tradingview mode pro trading	neutral
bayar gampang	positive
aplikasi rekomendasi temantransaksi cepat bagus banget	positive
great	positive
kecewa terus event server lambat	negative
nanovest unggul banding mudah paham sulit orang mula investasioke saja	positive
narik uang dana	neutral
investasi mudah	positive
mantap	positive
sih pas tambah rekening nama rekening ktp dah saja enggak hadeh tolong	negative
aplikasi hebat	positive
gue saran didownload aplikasi untung buntung	negative
need idrusd view setting so the exchange rate is transparent also ini my device the app trigger haptic feedback too much and i can not save trade confirmations and statements tapi my phone storage	neutral
okeh	positive
keren	positive
good project	positive
bagaimana witdraw bank bsi	neutral
sisa indikator signalnya bagus tari dana ribet efisien	positive
sumpah gua kesel benci akun gue saja invest tibatiba akun gua enggak buka tulis akses batas bel buka akun gue aneh banget gue enggak laku apa gue cuman investasi gue deposit tibatiba akun gue enggak gua kesel banget gue cuman tolong duit investasi gue balikin plis	negative
bagus	positive
good wallet	positive
nbt juang	positive
the best	positive
mudah bagus	positive
yeahh	positive
investasi aman awas ojk masuk referal saya hadiah unieequee	positive
fast respon	positive
okok	positive
aplikasi bagus lengkap costumer service responsif mantap	positive
aplikasi hp nanovest lambat banget	negative
tolong fitur jual saham pakai nominal rupiah ketimbang persen	neutral
bagus	positive
aplikasi bantu cinta crypto	positive
sip	positive
mudah paham	positive
ajar	neutral
lancar	neutral
uinya mudah paham keren	positive
mantap	positive
downlod ubah atur bayar biaya tambah minimal cek	neutral
kecewa enggak menang survey nanovest modalll	negative
maff belum saya kasih bintang dulu nnya kah ribu budah main mohon bantu kak terima kasih	positive
saldo isi survey	neutral
top aplikasi	positive
cocok investasi saham cripto	positive
mantap bagus aplikasi	positive
top up saldo mudah pas tarik uang sulit nanovest	negative
suka nanovest usaha bluechip murah beli saham	positive
mantulll	positive
kemarin beli saham saham beli enggak muncul	negative
nice good	positive
aplikasi bagus mula mudah paham	positive
aplikasi bagus simple laba rugi terlihatbintang sayang transaksi rp	positive
tari enggak ewlet	negative
sudah bagus simple responsive cuman ditambahin limit orderbuysell biar enggak pantengin marketaplikasi mulu mksih	neutral
nice banget	positive
app belum kendala sangat bantu newbie seperti tnx terus tumbuh kembang nano	positive
okey madep	positive
enggak verifikasi emailnyaudah kirim kode enggak masuk email	negative
aplikasi untung	positive
suka banget aplikasi wd cepat top up cepat mantap	positive
bantu mula invest crypto	positive
terima kasih costumer kak bahagia banget kembali akun	positive
enak enggak ribet love love	positive
kasih bintang hasil barupercobaan	neutral
syukur milik aplikasi nanovestsemoga depan manfaat orang sukses terima kasih	positive
bagus aplikasi	positive
bagus aplikasi nanovest moga wasilah sukses	positive
bantu investasi	positive
investasi asikringan jaga amanah tambah aset invest	positive
bagus ngisi luang	positive
enggak tarik dana	negative
alam pakai aplikasi bagus	positive
okokok	positive
simpel guna percaya appnya cepat informasi tolong sedia tarik uang app nanovest media yiutube	neutral
untung	positive
maaf ya kasih bintang enggak kirim kode verifikasi email sudah pakai nano best	negative
tingkat biar satset	neutral
sib coba	neutral
bagus banget aplikasi	positive
verifikasi email enggak bisa email enggak masuk masuk sudah ganti email enggak	negative
good project	positive
mudah erti aplikasi guna profit investasi	positive
mudah	positive
good bagus banget aplikasinyaui simpleminim bug pokok best proses jual beli cepat	positive
bagus mula	positive
markotop	positive
kecewa beli saham batal saldo kurang	negative
bagus buat mula investasi	positive
selawase	positive
bintang kalo bagus bintang tahan kalo ya turun bintang	positive
mantap fast respon layan	positive
aplikasi investasi kemas baikdengan gbnanosy serta ui ringan mudah erti mula sayasaham serta crypto bungkus pisah mudah guna transaksi terimakasih nanovest aplikasi simpel mudah dimengertisukses nanovest	positive
sidgembiz silah reffeeral dapat hadiah tarik	neutral
syukur aplikasi	positive
download terang	neutral
lumayan	positive
tolong benah tampil tablet	neutral
sudah bagus update tolong adakan fitur transfer coin exhange	positive
tau tahap ajar fiturnya mudah paham investor mula giat investasi trading tetap semangat kawan tetap laku baik	positive
mantabsluar	positive
top up beli crypto simple cepat akurat aplikasi turut ayo downloud nanovest	positive
moga lncar	positive
mula	neutral
jamin	positive
coba buy saran pas syarat tentu verifikasi kyc format html mohon baik ulas ubah user	positive
mantap aplikasi exchange	positive
kasih bintang pakai nanovest	positive
app celeh	negative
yoi	positive
mantap pokok	positive
mantap bantu	positive
bagus aplikasi yuk daftar isi reff untunginv biar dapat bonus aplikasi bagus investasi crypto baik percaya ragu aplikasi aplikasi aman percaya aplikasi puas layan customer service investasi mudah aman nyaman percaya yuk langsung bukti guys keren banget amanah pokok	positive
bagus mudah dipahamitransaksi cepat mudah paham	positive
bagus aplikasi mudah	positive
simple	positive
okee	positive
nanovest memang cuann	positive
mantap	positive
bagus aplikasiya	positive
easy	positive
hai nanountuk aplikasi bagus tambah ewallet tarik uang kasih bintang saja saran	positive
akun banned buka bagaimana nanovestnya kecewa	negative
aplikasi	positive
coba mudah mudah cocok dapat hadiah duga ref sandishan	neutral
sulit cuy narik uang sesal	negative
bagus enggak tampil informasi deviden saham as	positive
kembang kasih tingkat aplikasi	neutral
sdkt bingung awlnya tapi enjoy saja recommended app	positive
aneh grafik kendali	negative
fitur bagus mudah paham	positive
nice and quick response	positive
enggak jelas banget heranorg enggak ngapa mengapa akun batas	negative
kasih bintang dulu coba	neutral
investasi saham kripto jangka	positive
mantap mudah erti	positive
aplikasi bagus investasi	positive
bagus tolong tingkat aplikasi	positive
menginstal aplikasi suka aplikasi jenis kayak susahkurang easy user friendly tampil pertama	negative
fitur lock buka aplikasi ada keluh dengar batas kunci atur menit dll mohon asset kripto tampil kategori harga lihat mudah beli asset sekarang overall bagussemoga tahan aman percaya masyarakat memgapai finansial bagus	positive
aplikasi penuh animasi mudah	positive
puas	positive
apknya mudah fee enggak ngotak	neutral
ok tarik masuk reffereal inihfdtag dapat bonus	neutral
coba	neutral
cepat mudah	positive
good invest	positive
moga lancar	positive
force close pas buka mental aplikasi	negative
tingkat apaynya	neutral
iklan sih investasi rp	neutral
meme klin brise baby doge coin bonk koin partisipasi gas fee bone	neutral
aplikasi smooth responsif so far bagus ui	positive
lumayan	positive
coba kasih fitur tarik saldo dana gopay jadi simpel wd standar	neutral
coba	neutral
tolong baik verif saja ngulang kirim verif akun kali tolong direspon minnadmin	negative
wow	positive
cepat proses transaksi jual langsung sukses	positive
pertimbangkanpemakaian lonjak akun dibatasisangat riskan	negative
moga awet	neutral
biadab nanovest saldo aplikasi kok kunci	negative
goodjob	positive
ok mantap	positive
aplikasi kasih	positive
tolong update verif email kode otpnya kirim	neutral
transaksi cepat satsetsatset	positive
mantaap	positive
tari status berhasiltapi masuk	negative
sippppp	positive
sahabat mula moga aman jaga	positive
suka	positive
ounya akun enggak login jelek	negative
tari ewallet enggak kasih solusi tari ewallet contoh virtual akun digunain transaksi bank uang sudah tahan kemarin enggak tetap saja itu uang ira top up tari via ewallet top up saja ewallet tari bank itu enggak virtual akun bank ewallet	negative
gua beli coin harga rp kebel harga rp padahal cart kagak harga segitu anjim mentok harga harga gua gua lihat tuh langsung unninstal enggak rekomen	negative
mantap nanovest	positive
moga lancar	positive
oyeslah pokok	positive
bmembuang iklan	positive
keren	positive
intip dikit	neutral
kalau tarik via dana gopay tolong pencet ya komentar gue	positive
mantap pokok aplikasi investasi ribet	positive
keren	positive
nomor akun hapus tolong bagaimana akun pakai nomor	negative
bagus mudah erti ribet	positive
keren	positive
aplikasi bagus puas	positive
tbh app mudah lebih paham crypto saham bgtulah dapat mula	positive
amazing	positive
enggak bisa buka propil malah kluar terus	negative
good job	positive
berat aplikasi	negative
aplikasi bagus investasi mula	positive
gas	positive
verifikasi	negative
display oke fitur minim	neutral
opsi kembali akun hapus alas sengaja akun hapus nanovest sayang login akun pakai ktp bintang solusi kait	neutral
aplikasi mudah simple no ribet	positive
aplikasi tarik auto bantu	positive
keren tarik uang langsung masuk rekening	positive
sama coba gabung install aplikasi enggak dibukaa stack bagi buat pin	negative
bagus mudah	positive
mudah mudah aplikasi nanovest resmi abal abal	positive
joz	positive
ok pokok	positive
saran tari pakai e walet biar mudah ajar atm pasa suruh atm narik update kasih fitur narik pakai e walet	neutral
mantap	positive
tahap ajar	neutral
ok ok usaha belum tau	neutral
tolong data orang nano vast	neutral
aplikasi sulit erti	negative
lengkapin kyc saja susah	negative
investasi bagus mudah paham aplikasi nini tarik saldo enggak narik ewallet langsung top up saldo nanovest sudah sedia ewallet tambah tari ewallet mudah saja	neutral
amanah aman	positive
undang akun benistwn	neutral
investasi mudah senang	positive
amazing fast fast fast transaksi	positive
good app	positive
nanovest jaya	positive
investasi sederhana simplepertahankan imvestasi ramah	positive
mohon maaf aplikasi pending hp masalah sampah bersih	negative
koin barubaru biar enggak telat beli nanovest	neutral
ok banget nanovest kagak ribet	positive
best	positive
wow aplikasi baik enggak sangka buat negeri	positive
lelet	negative
aplikasi	neutral
biaya pajak mahal mafia nanovest hati hati trading rekomendes	negative
e i iii	neutral
mantap	positive
mudah moga amanah ya nanovest	positive
cocok	positive
aman enggak sebar data	positive
tibatiba log ini ulang dana juta masuk no wa daftar kirim kode otp kode kirim wa log ini dana ancam hilang tolong nanovest merespon log ini	negative
nanovest baik tercept	positive
cepat transfer coin akun saja	neutral
kendala kalow tari ewallet lagih enggak puya rekening bingung	neutral
juang rupiah semangat	positive
bagus simplr	positive
aplikasi bagussemoga depan bagus	positive
bagus mudah erti	positive
biaya tari dana	negative
tarik	positive
bagus cepat	positive
mantap pokok minimal beli murah jangkau moga sukses	positive
moga depan nanovest support tari ewallet dana ovo gopay dll terima kasih sukses nanovest	neutral
mudah tampil tarik	positive
yuk yuk	neutral
mudah pakai	positive
enggak angin enggak ujan akun batas mau	negative
hebat	positive
baik dari semua aplikasi investasi lai	positive
tolong tari uang pakai ewallet kalo sudah tambah bintang	neutral
aplikasi bagus	positive
mudah praktis guna bravo	positive
good easy for app	positive
pas verifikasi email susah	negative
sjahahakakan	neutral
top aplikasi	positive
wer	positive
alam	positive
mudah	positive
gwechnaa	neutral
proses cepat	positive
investasi rutin	neutral
easy use for newbe	positive
mudah apknya	positive
belah crypto new beli rbdi paling ribu	positive
moga jalan lancar	positive
tambah undang cumisoton	neutral
aplikasi mudah terimakasih	positive
invest dinanovest mantap	positive
very good project	positive
akun nanovest sengaja hapus atas	neutral
jera jera enggak pakai aplikasi lagikemarin withdraw binance pakai jaring bep alamat benarketika cek dibinance enggak masuk pas hubung bantu refundkata agen nyagak luar tanggung kamisebaiknya kakak hubung agen aplikasi wd tersebutbinance tau begitu enggak pakai appmemang enggak kkalo karena beli sel gaj pakai aplikasi nanoves	negative
aplikasi invest buruk coba beli saham mamarika sdikit hilang portofolio entah didelist bagaimana kalau delist asih info ya jangan hilang	negative
bagus appsnya	positive
member hati hati scam kedok invest perhati market buka untung saham potong saham jual jual kena potong hati hati ponzi	negative
aplikasi tidak masuk jelek	neutral
please tambah fitur limit order stop loss crypto	neutral
maaf akun kode nya kasih sama orang bagaimana nya enggak bukamohon bantu nya	neutral
vaik	positive
doklik insha allah barokah	neutral
aplikasi mudah mu investasi	positive
pakai ktp digital ikd perintah keluar ektp mohon maaf pakai exchange	negative
lumayan modal dikit	positive
mantap	positive
aplikasi beli crypto saham mudah akun mudah top up mudah harga cocok kaum receh unggul kendala kendala alami jual crypto untung sekitar ancoba narik tera struknya masuk saldo wallet beli moga tingkat bug tidak sesuai distruk	neutral
eror update android	negative
suruh install muluk ya	negative
bagus apkasinya cepat	positive
gue belum coba cuman kadang apknya lambat	neutral
investasi rekomendit banget mula manfaat banget mantap	positive
aplikasi mantap ragu mantap	positive
cool	positive
